Nick Cottrell's Maze Project

      ___                    ___           ___           ___           ___     
     /  /\                  /__/\         /  /\         /  /\         /  /\    
    /  /::\                |  |::\       /  /::\       /  /::|       /  /:/_   
   /  /:/\:\               |  |:|:\     /  /:/\:\     /  /:/:|      /  /:/ /\  
  /  /:/~/::\            __|__|:|\:\   /  /:/~/::\   /  /:/|:|__   /  /:/ /:/_ 
 /__/:/ /:/\:\          /__/::::| \:\ /__/:/ /:/\:\ /__/:/ |:| /\ /__/:/ /:/ /\
 \  \:\/:/__\/          \  \:\~~\__\/ \  \:\/:/__\/ \__\/  |:|/:/ \  \:\/:/ /:/
  \  \::/                \  \:\        \  \::/          |  |:/:/   \  \::/ /:/ 
   \  \:\                 \  \:\        \  \:\          |  |::/     \  \:\/:/  
    \  \:\                 \  \:\        \  \:\         |  |:/       \  \::/   
     \__\/                  \__\/         \__\/         |__|/         \__\/    


This project is part of Udacity's VR Developer Nanodegree
https://www.udacity.com/course/vr-developer-nanodegree--nd017
Versions
- Patch 2017.1.0p4
- GVR Unity SDK v1.70.0

